{
  "format": 1,
  "record_size": 4,
  "records": [
    [0, 4, 0, 0],
    [0, 0, 0, 0],
    [7, 4, 12, 0],
    [3, 4, 0, 0],
    [1, 4, 2, 0],
    [1, 2, 0, 0],
    [4, 4, 0, 0],
    [7, 0, 6, 0],
    [7, 0, 4, 0],
    [0, 1, 0, 0]
  ]
}
