{
  "format": 1,
  "terminators": ["0xfe00", "0xffff"],
  "queues": [
    {
      "header": "0xfd00",
      "commands": [
        [1346, 2],
        [1344, 0],
        [1378, 2],
        [1376, 6],
        [1348, 2],
        [1344, 0],
        [1380, 2],
        [1376, 6],
        [1350, 2],
        [1344, 0],
        [1382, 2],
        [1376, 6],
        [1352, 2],
        [1344, 0],
        [1384, 2],
        [1376, 6],
        [1354, 2],
        [1344, 0],
        [1386, 2],
        [1376, 6],
        [1356, 2],
        [1344, 0],
        [1388, 2],
        [1376, 6]
      ]
    }
  ]
}
