{
  "format": 1,
  "record_size": 4,
  "records": [
    [0, 0, 0, 0],
    [0, 4, 0, 0],
    [3, 4, 0, 0],
    [4, 4, 0, 0],
    [4, 0, 8, 0],
    [0, 8, 0, 0],
    [3, 8, 0, 0],
    [4, 0, 4, 0],
    [4, 0, 2, 0],
    [4, 2, 4, 0],
    [3, 0, 4, 0],
    [0, 2, 0, 0]
  ]
}
