{
  "format": 1,
  "terminators": ["0xfe00", "0xffff"],
  "queues": [
    {
      "header": "0xfd00",
      "commands": [
        [1536, 4],
        [1408, 0],
        [1568, 4],
        [1440, 0],
        [1600, 4],
        [1472, 0],
        [1632, 4],
        [1504, 2],
        [1540, 4],
        [1408, 0],
        [1572, 4],
        [1440, 0],
        [1604, 4],
        [1472, 0],
        [1636, 4],
        [1504, 2],
        [1544, 4],
        [1408, 0],
        [1576, 4],
        [1440, 0],
        [1608, 4],
        [1472, 0],
        [1640, 4],
        [1504, 2],
        [1548, 4],
        [1408, 0],
        [1580, 4],
        [1440, 0],
        [1612, 4],
        [1472, 0],
        [1644, 4],
        [1504, 2],
        [1552, 4],
        [1408, 0],
        [1584, 4],
        [1440, 0],
        [1616, 4],
        [1472, 0],
        [1648, 4],
        [1504, 2],
        [1556, 4],
        [1408, 0],
        [1588, 4],
        [1440, 0],
        [1620, 4],
        [1472, 0],
        [1652, 4],
        [1504, 2],
        [1560, 4],
        [1408, 0],
        [1592, 4],
        [1440, 0],
        [1624, 4],
        [1472, 0],
        [1656, 4],
        [1504, 2],
        [1564, 4],
        [1408, 0],
        [1596, 4],
        [1440, 0],
        [1628, 4],
        [1472, 0],
        [1660, 4],
        [1504, 2]
      ]
    },
    {
      "header": "0xfd01",
      "commands": [
        [1668, 4],
        [14, 0],
        [1700, 4],
        [46, 0],
        [1732, 4],
        [78, 0],
        [1764, 4],
        [110, 2],
        [1672, 4],
        [14, 0],
        [1704, 4],
        [46, 0],
        [1736, 4],
        [78, 0],
        [1768, 4],
        [110, 120],
        [1668, 4],
        [14, 0],
        [1700, 4],
        [46, 0],
        [1732, 4],
        [78, 0],
        [1764, 4],
        [110, 2]
      ]
    },
    {
      "header": "0xfd02",
      "commands": [
        [1678, 2],
        [20, 0],
        [1710, 2],
        [52, 0],
        [1742, 2],
        [84, 0],
        [1774, 2],
        [116, 2],
        [1680, 2],
        [20, 0],
        [1712, 2],
        [52, 0],
        [1744, 2],
        [84, 0],
        [1776, 2],
        [116, 120],
        [1678, 2],
        [20, 0],
        [1710, 2],
        [52, 0],
        [1742, 2],
        [84, 0],
        [1774, 2],
        [116, 2]
      ]
    },
    {
      "header": "0xfd03",
      "commands": [
        [1682, 2],
        [1156, 0],
        [1714, 2],
        [1188, 8],
        [1684, 2],
        [1156, 0],
        [1716, 2],
        [1188, 8],
        [1686, 2],
        [1156, 0],
        [1718, 2],
        [1188, 8],
        [1688, 2],
        [1156, 0],
        [1720, 2],
        [1188, 8],
        [1686, 2],
        [1156, 0],
        [1718, 2],
        [1188, 8],
        [1684, 2],
        [1156, 0],
        [1716, 2],
        [1188, 8]
      ]
    },
    {
      "header": "0xfd04",
      "commands": [
        [1792, 6],
        [1362, 0],
        [1824, 6],
        [1394, 0],
        [1856, 6],
        [1426, 0],
        [1888, 6],
        [1458, 0],
        [1920, 6],
        [1490, 0],
        [1952, 6],
        [1522, 4],
        [1798, 6],
        [1362, 0],
        [1830, 6],
        [1394, 0],
        [1862, 6],
        [1426, 0],
        [1894, 6],
        [1458, 0],
        [1926, 6],
        [1490, 0],
        [1958, 6],
        [1522, 4],
        [1804, 6],
        [1362, 0],
        [1836, 6],
        [1394, 0],
        [1868, 6],
        [1426, 0],
        [1900, 6],
        [1458, 0],
        [1932, 6],
        [1490, 0],
        [1964, 6],
        [1522, 4],
        [1810, 6],
        [1362, 0],
        [1842, 6],
        [1394, 0],
        [1874, 6],
        [1426, 0],
        [1906, 6],
        [1458, 0],
        [1938, 6],
        [1490, 0],
        [1970, 6],
        [1522, 4]
      ]
    }
  ]
}
