{
  "format": 1,
  "record_size": 4,
  "records": [
    [0, 4, 0, 0],
    [0, 0, 0, 0],
    [0, 6, 0, 0],
    [3, 6, 4, 0],
    [4, 6, 4, 0],
    [3, 4, 0, 0],
    [4, 4, 0, 0],
    [3, 4, 6, 0],
    [4, 4, 6, 0],
    [1, 0, 2, 0],
    [1, 2, 4, 0],
    [3, 0, 2, 0],
    [4, 0, 2, 0],
    [0, 2, 0, 0],
    [3, 2, 4, 0],
    [3, 2, 0, 0],
    [4, 2, 0, 0]
  ]
}
