{
  "format": 1,
  "record_size": 4,
  "records": [
    [0, 0, 0, 0],
    [0, 4, 0, 0],
    [4, 4, 0, 0],
    [3, 4, 0, 0],
    [13, 4, 4, 0],
    [12, 4, 0, 0],
    [9, 4, 0, 0],
    [0, 2, 0, 0],
    [12, 2, 0, 0],
    [9, 2, 0, 0],
    [13, 2, 2, 0],
    [9, 0, 4, 0],
    [8, 0, 4, 0],
    [4, 0, 4, 0],
    [8, 4, 0, 0],
    [13, 4, 0, 0],
    [8, 0, 1, 0],
    [0, 1, 0, 0],
    [8, 1, 0, 0],
    [9, 4, 1, 0],
    [2, 1, 0, 0],
    [12, 4, 4, 0],
    [12, 0, 0, 4],
    [2, 3, 2, 0],
    [2, 2, 1, 0],
    [2, 0, 255, 0],
    [2, 255, 254, 0],
    [3, 0, 4, 0],
    [13, 0, 0, 4]
  ]
}
