{
  "format": 1,
  "terminators": ["0xfe00", "0xffff"],
  "queues": [
    {
      "header": "0xfd00",
      "commands": [
        [1536, 4],
        [1420, 0],
        [1568, 4],
        [1452, 0],
        [1600, 4],
        [1484, 0],
        [1632, 4],
        [1516, 4],
        [1540, 4],
        [1420, 0],
        [1572, 4],
        [1452, 0],
        [1604, 4],
        [1484, 0],
        [1636, 4],
        [1516, 4],
        [1544, 4],
        [1420, 0],
        [1576, 4],
        [1452, 0],
        [1608, 4],
        [1484, 0],
        [1640, 4],
        [1516, 4],
        [1548, 4],
        [1420, 0],
        [1580, 4],
        [1452, 0],
        [1612, 4],
        [1484, 0],
        [1644, 4],
        [1516, 4],
        [1552, 4],
        [1420, 0],
        [1584, 4],
        [1452, 0],
        [1616, 4],
        [1484, 0],
        [1648, 4],
        [1516, 4],
        [1664, 4],
        [1420, 0],
        [1696, 4],
        [1452, 0],
        [1728, 4],
        [1484, 0],
        [1760, 4],
        [1516, 4],
        [1668, 4],
        [1420, 0],
        [1700, 4],
        [1452, 0],
        [1732, 4],
        [1484, 0],
        [1764, 4],
        [1516, 4],
        [1672, 4],
        [1420, 0],
        [1704, 4],
        [1452, 0],
        [1736, 4],
        [1484, 0],
        [1768, 4],
        [1516, 4],
        [1676, 4],
        [1420, 0],
        [1708, 4],
        [1452, 0],
        [1740, 4],
        [1484, 0],
        [1772, 4],
        [1516, 4],
        [1680, 4],
        [1420, 0],
        [1712, 4],
        [1452, 0],
        [1744, 4],
        [1484, 0],
        [1776, 4],
        [1516, 4]
      ]
    },
    {
      "header": "0xfd01",
      "commands": [
        [1556, 3],
        [1424, 0],
        [1588, 3],
        [1456, 0],
        [1620, 3],
        [1488, 8],
        [1559, 3],
        [1424, 0],
        [1591, 3],
        [1456, 0],
        [1623, 3],
        [1488, 8],
        [1562, 3],
        [1424, 0],
        [1594, 3],
        [1456, 0],
        [1626, 3],
        [1488, 8],
        [1559, 3],
        [1424, 0],
        [1591, 3],
        [1456, 0],
        [1623, 3],
        [1488, 8]
      ]
    }
  ]
}
