{
  "format": 1,
  "terminators": ["0xfe00", "0xffff"],
  "queues": [
    {
      "header": "0xfd00",
      "commands": [
        [1536, 2],
        [1152, 0],
        [1568, 2],
        [1184, 10],
        [1538, 2],
        [1152, 0],
        [1570, 2],
        [1184, 10],
        [1540, 2],
        [1152, 0],
        [1572, 2],
        [1184, 10],
        [1542, 2],
        [1152, 0],
        [1574, 2],
        [1184, 10],
        [1540, 2],
        [1152, 0],
        [1572, 2],
        [1184, 10],
        [1538, 2],
        [1152, 0],
        [1570, 2],
        [1184, 10]
      ]
    },
    {
      "header": "0xfd01",
      "commands": [
        [1600, 3],
        [1216, 0],
        [1632, 3],
        [1248, 0],
        [1664, 3],
        [1280, 8],
        [1603, 3],
        [1216, 0],
        [1635, 3],
        [1248, 0],
        [1667, 3],
        [1280, 8],
        [1606, 3],
        [1216, 0],
        [1638, 3],
        [1248, 0],
        [1670, 3],
        [1280, 8],
        [1609, 3],
        [1216, 0],
        [1641, 3],
        [1248, 0],
        [1673, 3],
        [1280, 8],
        [1606, 3],
        [1216, 0],
        [1638, 3],
        [1248, 0],
        [1670, 3],
        [1280, 8],
        [1603, 3],
        [1216, 0],
        [1635, 3],
        [1248, 0],
        [1667, 3],
        [1280, 8]
      ]
    },
    {
      "header": "0xfd02",
      "commands": [
        [1548, 4],
        [1312, 0],
        [1580, 4],
        [1344, 0],
        [1612, 4],
        [1376, 0],
        [1644, 4],
        [1408, 0],
        [1676, 4],
        [1440, 0],
        [1708, 4],
        [1472, 0],
        [1740, 4],
        [1504, 5],
        [1552, 4],
        [1312, 0],
        [1584, 4],
        [1344, 0],
        [1616, 4],
        [1376, 0],
        [1648, 4],
        [1408, 0],
        [1680, 4],
        [1440, 0],
        [1712, 4],
        [1472, 0],
        [1744, 4],
        [1504, 4],
        [1556, 4],
        [1312, 0],
        [1588, 4],
        [1344, 0],
        [1620, 4],
        [1376, 0],
        [1652, 4],
        [1408, 0],
        [1684, 4],
        [1440, 0],
        [1716, 4],
        [1472, 0],
        [1748, 4],
        [1504, 5],
        [1552, 4],
        [1312, 0],
        [1584, 4],
        [1344, 0],
        [1616, 4],
        [1376, 0],
        [1648, 4],
        [1408, 0],
        [1680, 4],
        [1440, 0],
        [1712, 4],
        [1472, 0],
        [1744, 4],
        [1504, 4]
      ]
    },
    {
      "header": "0xfd03",
      "commands": [
        [1792, 2],
        [1090, 0],
        [1824, 2],
        [1122, 6],
        [1794, 2],
        [1090, 0],
        [1826, 2],
        [1122, 6],
        [1796, 2],
        [1090, 0],
        [1828, 2],
        [1122, 6],
        [1798, 2],
        [1090, 0],
        [1830, 2],
        [1122, 6],
        [1800, 2],
        [1090, 0],
        [1832, 2],
        [1122, 6],
        [1802, 2],
        [1090, 0],
        [1834, 2],
        [1122, 6],
        [1804, 2],
        [1090, 0],
        [1836, 2],
        [1122, 6],
        [1806, 2],
        [1090, 0],
        [1838, 2],
        [1122, 6],
        [1808, 2],
        [1090, 0],
        [1840, 2],
        [1122, 6],
        [1810, 2],
        [1090, 0],
        [1842, 2],
        [1122, 6]
      ]
    },
    {
      "header": "0xfd04",
      "commands": [
        [1696, 2],
        [1056, 0],
        [1728, 2],
        [1088, 0],
        [1760, 2],
        [1120, 10],
        [1698, 2],
        [1056, 0],
        [1730, 2],
        [1088, 0],
        [1762, 2],
        [1120, 10],
        [1700, 2],
        [1056, 0],
        [1732, 2],
        [1088, 0],
        [1764, 2],
        [1120, 10],
        [1702, 2],
        [1056, 0],
        [1734, 2],
        [1088, 0],
        [1766, 2],
        [1120, 10],
        [1704, 2],
        [1056, 0],
        [1736, 2],
        [1088, 0],
        [1768, 2],
        [1120, 10]
      ]
    },
    {
      "header": "0xfd05",
      "commands": [
        [1856, 2],
        [1361, 0],
        [1888, 2],
        [1393, 0],
        [1920, 2],
        [1425, 0],
        [1952, 2],
        [1457, 0],
        [1984, 2],
        [1489, 0],
        [2016, 2],
        [1521, 80],
        [1858, 2],
        [1361, 0],
        [1890, 2],
        [1393, 0],
        [1922, 2],
        [1425, 0],
        [1954, 2],
        [1457, 0],
        [1986, 2],
        [1489, 0],
        [2018, 2],
        [1521, 80],
        [1860, 2],
        [1361, 0],
        [1892, 2],
        [1393, 0],
        [1924, 2],
        [1425, 0],
        [1956, 2],
        [1457, 0],
        [1988, 2],
        [1489, 0],
        [2020, 2],
        [1521, 80],
        [1858, 2],
        [1361, 0],
        [1890, 2],
        [1393, 0],
        [1922, 2],
        [1425, 0],
        [1954, 2],
        [1457, 0],
        [1986, 2],
        [1489, 0],
        [2018, 2],
        [1521, 80]
      ]
    },
    {
      "header": "0xfd06",
      "commands": [
        [1862, 3],
        [1222, 0],
        [1894, 3],
        [1254, 0],
        [1926, 3],
        [1286, 4],
        [1865, 3],
        [1222, 0],
        [1897, 3],
        [1254, 0],
        [1929, 3],
        [1286, 4],
        [1868, 3],
        [1222, 0],
        [1900, 3],
        [1254, 0],
        [1932, 3],
        [1286, 4],
        [1958, 3],
        [1222, 0],
        [1990, 3],
        [1254, 0],
        [2022, 3],
        [1286, 4],
        [1961, 3],
        [1222, 0],
        [1993, 3],
        [1254, 0],
        [2025, 3],
        [1286, 4],
        [1964, 3],
        [1222, 0],
        [1996, 3],
        [1254, 0],
        [2028, 3],
        [1286, 4]
      ]
    }
  ]
}
