{
  "format": 1,
  "record_size": 4,
  "records": [
    [0, 0, 0, 0],
    [0, 2, 0, 0],
    [0, 4, 0, 0],
    [8, 0, 2, 0],
    [9, 2, 0, 0],
    [3, 2, 0, 0],
    [4, 2, 0, 0],
    [8, 2, 0, 0],
    [9, 0, 2, 0],
    [3, 0, 2, 0],
    [4, 0, 2, 0],
    [9, 4, 0, 0],
    [8, 0, 4, 0],
    [7, 0, 2, 0]
  ]
}
