{
  "format": 1,
  "record_size": 4,
  "records": [
    [0, 0, 0, 0],
    [3, 4, 0, 0],
    [8, 0, 1, 0],
    [0, 1, 0, 0],
    [8, 1, 0, 0],
    [4, 4, 0, 0],
    [9, 4, 1, 0],
    [2, 1, 0, 0],
    [9, 0, 4, 0],
    [0, 4, 0, 0],
    [8, 0, 4, 0]
  ]
}
