{
  "format": 1,
  "record_size": 4,
  "records": [
    [0, 0, 0, 0],
    [3, 0, 8, 0],
    [0, 8, 0, 0],
    [4, 0, 8, 0],
    [4, 0, 2, 0],
    [0, 6, 0, 0],
    [7, 8, 12, 0],
    [3, 2, 4, 0],
    [0, 4, 0, 0],
    [4, 2, 4, 0],
    [4, 8, 0, 0],
    [7, 4, 8, 0],
    [0, 16, 0, 0],
    [1, 4, 6, 0],
    [1, 6, 8, 0],
    [3, 8, 0, 0],
    [0, 12, 0, 0],
    [4, 4, 0, 0],
    [3, 4, 0, 0],
    [1, 4, 2, 0],
    [1, 2, 0, 0],
    [2, 0, 8, 0],
    [0, 3, 0, 0],
    [0, 2, 0, 0],
    [9, 2, 0, 0],
    [3, 0, 2, 0],
    [7, 0, 4, 0],
    [7, 0, 2, 0]
  ]
}
