{
  "format": 1,
  "record_size": 4,
  "records": [
    [0, 0, 0, 0],
    [0, 4, 0, 0],
    [4, 4, 0, 0],
    [0, 6, 0, 0],
    [0, 8, 0, 0],
    [8, 4, 6, 0],
    [8, 4, 8, 0],
    [3, 4, 0, 0],
    [8, 0, 2, 0],
    [0, 2, 0, 0],
    [2, 4, 2, 0],
    [2, 2, 0, 0],
    [3, 0, 4, 0],
    [4, 0, 4, 0],
    [1, 0, 1, 0],
    [1, 1, 2, 0],
    [1, 2, 3, 0],
    [0, 20, 0, 0],
    [0, 10, 0, 0],
    [0, 60, 0, 0],
    [1, 22, 20, 0],
    [0, 16, 0, 0],
    [0, 12, 0, 0],
    [3, 8, 4, 0],
    [8, 2, 0, 0],
    [1, 3, 2, 0],
    [1, 2, 1, 0],
    [1, 1, 0, 0],
    [4, 254, 0, 0],
    [3, 252, 0, 0],
    [4, 0, 252, 0]
  ]
}
