{
  "format": 1,
  "terminators": ["0xfe00", "0xffff"],
  "queues": [
    {
      "header": "0xfd00",
      "commands": [
        [1566, 2],
        [1366, 0],
        [1598, 2],
        [1398, 10],
        [1630, 2],
        [1366, 0],
        [1662, 2],
        [1398, 10],
        [1694, 2],
        [1366, 0],
        [1726, 2],
        [1398, 10],
        [1630, 2],
        [1366, 0],
        [1662, 2],
        [1398, 10]
      ]
    },
    {
      "header": "0xfd01",
      "commands": [
        [1536, 3],
        [918, 0],
        [1568, 3],
        [950, 0],
        [1600, 3],
        [982, 0],
        [1632, 3],
        [1014, 8],
        [1664, 3],
        [918, 0],
        [1696, 3],
        [950, 0],
        [1728, 3],
        [982, 0],
        [1760, 3],
        [1014, 8],
        [1541, 3],
        [918, 0],
        [1573, 3],
        [950, 0],
        [1605, 3],
        [982, 0],
        [1637, 3],
        [1014, 8],
        [1664, 3],
        [918, 0],
        [1696, 3],
        [950, 0],
        [1728, 3],
        [982, 0],
        [1760, 3],
        [1014, 8]
      ]
    },
    {
      "header": "0xfd02",
      "commands": [
        [1548, 6],
        [1104, 0],
        [1580, 6],
        [1136, 0],
        [1612, 6],
        [1168, 0],
        [1644, 6],
        [1200, 0],
        [1676, 6],
        [1232, 0],
        [1708, 6],
        [1264, 0],
        [1740, 6],
        [1296, 0],
        [1772, 6],
        [1328, 8],
        [1554, 6],
        [1104, 0],
        [1586, 6],
        [1136, 0],
        [1618, 6],
        [1168, 0],
        [1650, 6],
        [1200, 0],
        [1682, 6],
        [1232, 0],
        [1714, 6],
        [1264, 0],
        [1746, 6],
        [1296, 0],
        [1778, 6],
        [1328, 8],
        [1560, 6],
        [1104, 0],
        [1592, 6],
        [1136, 0],
        [1624, 6],
        [1168, 0],
        [1656, 6],
        [1200, 0],
        [1688, 6],
        [1232, 0],
        [1720, 6],
        [1264, 0],
        [1752, 6],
        [1296, 0],
        [1784, 6],
        [1328, 8],
        [1554, 6],
        [1104, 0],
        [1586, 6],
        [1136, 0],
        [1618, 6],
        [1168, 0],
        [1650, 6],
        [1200, 0],
        [1682, 6],
        [1232, 0],
        [1714, 6],
        [1264, 0],
        [1746, 6],
        [1296, 0],
        [1778, 6],
        [1328, 8]
      ]
    }
  ]
}
