{
  "format": 1,
  "terminators": ["0xfe00", "0xffff"],
  "queues": [
    {
      "header": "0xfd00",
      "commands": [
        [1600, 16],
        [972, 2],
        [1616, 16],
        [972, 2],
        [1632, 16],
        [972, 2],
        [1616, 16],
        [972, 2]
      ]
    },
    {
      "header": "0xfd01",
      "commands": [
        [1648, 4],
        [988, 2],
        [1652, 4],
        [988, 2],
        [1656, 4],
        [988, 2],
        [1652, 4],
        [988, 2]
      ]
    },
    {
      "header": "0xfd02",
      "commands": [
        [1536, 8],
        [992, 2],
        [1544, 8],
        [992, 2],
        [1552, 8],
        [992, 2],
        [1560, 8],
        [992, 2],
        [1568, 8],
        [992, 2],
        [1576, 8],
        [992, 2],
        [1584, 8],
        [992, 2],
        [1592, 8],
        [992, 2]
      ]
    },
    {
      "header": "0xfd03",
      "commands": [
        [1664, 24],
        [1000, 2],
        [1696, 24],
        [1000, 2],
        [1728, 24],
        [1000, 2],
        [1760, 24],
        [1000, 2],
        [1792, 24],
        [1000, 2],
        [1824, 24],
        [1000, 2],
        [1856, 24],
        [1000, 2],
        [1888, 24],
        [1000, 2]
      ]
    },
    {
      "header": "0xfd04",
      "commands": [
        [1820, 4],
        [1036, 0],
        [1852, 4],
        [1068, 0],
        [1884, 4],
        [1100, 0],
        [1916, 4],
        [1132, 24],
        [1928, 4],
        [1036, 0],
        [1960, 4],
        [1068, 0],
        [1992, 4],
        [1100, 0],
        [2024, 4],
        [1132, 18],
        [1940, 4],
        [1036, 0],
        [1972, 4],
        [1068, 0],
        [2004, 4],
        [1100, 0],
        [2036, 4],
        [1132, 64],
        [1928, 4],
        [1036, 0],
        [1960, 4],
        [1068, 0],
        [1992, 4],
        [1100, 0],
        [2024, 4],
        [1132, 18]
      ]
    },
    {
      "header": "0xfd05",
      "commands": [
        [1920, 4],
        [1052, 0],
        [1952, 4],
        [1084, 0],
        [1984, 4],
        [1116, 0],
        [2016, 4],
        [1148, 24],
        [1932, 4],
        [1052, 0],
        [1964, 4],
        [1084, 0],
        [1996, 4],
        [1116, 0],
        [2028, 4],
        [1148, 18],
        [1944, 4],
        [1052, 0],
        [1976, 4],
        [1084, 0],
        [2008, 4],
        [1116, 0],
        [2040, 4],
        [1148, 64],
        [1932, 4],
        [1052, 0],
        [1964, 4],
        [1084, 0],
        [1996, 4],
        [1116, 0],
        [2028, 4],
        [1148, 18]
      ]
    },
    {
      "header": "0xfd06",
      "commands": [
        [1924, 4],
        [1152, 0],
        [1956, 4],
        [1184, 0],
        [1988, 4],
        [1216, 0],
        [2020, 4],
        [1248, 24],
        [1936, 4],
        [1152, 0],
        [1968, 4],
        [1184, 0],
        [2000, 4],
        [1216, 0],
        [2032, 4],
        [1248, 18],
        [1948, 4],
        [1152, 0],
        [1980, 4],
        [1184, 0],
        [2012, 4],
        [1216, 0],
        [2044, 4],
        [1248, 64],
        [1936, 4],
        [1152, 0],
        [1968, 4],
        [1184, 0],
        [2000, 4],
        [1216, 0],
        [2032, 4],
        [1248, 18]
      ]
    },
    {
      "header": "0xfd07",
      "commands": [
        [1688, 4],
        [1156, 0],
        [1720, 4],
        [1188, 0],
        [1752, 4],
        [1220, 0],
        [1784, 4],
        [1252, 24],
        [1692, 4],
        [1156, 0],
        [1724, 4],
        [1188, 0],
        [1756, 4],
        [1220, 0],
        [1788, 4],
        [1252, 18],
        [1816, 4],
        [1156, 0],
        [1848, 4],
        [1188, 0],
        [1880, 4],
        [1220, 0],
        [1912, 4],
        [1252, 64],
        [1692, 4],
        [1156, 0],
        [1724, 4],
        [1188, 0],
        [1756, 4],
        [1220, 0],
        [1788, 4],
        [1252, 18]
      ]
    }
  ]
}
