{
  "format": 1,
  "terminators": ["0xfe00", "0xffff"],
  "queues": [
    {
      "header": "0xfd00",
      "commands": [
        [1536, 2],
        [1152, 0],
        [1568, 2],
        [1184, 10],
        [1538, 2],
        [1152, 0],
        [1570, 2],
        [1184, 10],
        [1540, 2],
        [1152, 0],
        [1572, 2],
        [1184, 10],
        [1542, 2],
        [1152, 0],
        [1574, 2],
        [1184, 10],
        [1540, 2],
        [1152, 0],
        [1572, 2],
        [1184, 10],
        [1538, 2],
        [1152, 0],
        [1570, 2],
        [1184, 10]
      ]
    },
    {
      "header": "0xfd01",
      "commands": [
        [1600, 3],
        [1216, 0],
        [1632, 3],
        [1248, 0],
        [1664, 3],
        [1280, 8],
        [1603, 3],
        [1216, 0],
        [1635, 3],
        [1248, 0],
        [1667, 3],
        [1280, 8],
        [1606, 3],
        [1216, 0],
        [1638, 3],
        [1248, 0],
        [1670, 3],
        [1280, 8],
        [1609, 3],
        [1216, 0],
        [1641, 3],
        [1248, 0],
        [1673, 3],
        [1280, 8],
        [1606, 3],
        [1216, 0],
        [1638, 3],
        [1248, 0],
        [1670, 3],
        [1280, 8],
        [1603, 3],
        [1216, 0],
        [1635, 3],
        [1248, 0],
        [1667, 3],
        [1280, 8]
      ]
    },
    {
      "header": "0xfd02",
      "commands": [
        [1548, 4],
        [1312, 0],
        [1580, 4],
        [1344, 0],
        [1612, 4],
        [1376, 0],
        [1644, 4],
        [1408, 0],
        [1676, 4],
        [1440, 0],
        [1708, 4],
        [1472, 0],
        [1740, 4],
        [1504, 5],
        [1552, 4],
        [1312, 0],
        [1584, 4],
        [1344, 0],
        [1616, 4],
        [1376, 0],
        [1648, 4],
        [1408, 0],
        [1680, 4],
        [1440, 0],
        [1712, 4],
        [1472, 0],
        [1744, 4],
        [1504, 4],
        [1556, 4],
        [1312, 0],
        [1588, 4],
        [1344, 0],
        [1620, 4],
        [1376, 0],
        [1652, 4],
        [1408, 0],
        [1684, 4],
        [1440, 0],
        [1716, 4],
        [1472, 0],
        [1748, 4],
        [1504, 5],
        [1552, 4],
        [1312, 0],
        [1584, 4],
        [1344, 0],
        [1616, 4],
        [1376, 0],
        [1648, 4],
        [1408, 0],
        [1680, 4],
        [1440, 0],
        [1712, 4],
        [1472, 0],
        [1744, 4],
        [1504, 4]
      ]
    },
    {
      "header": "0xfd03",
      "commands": [
        [1544, 2],
        [1322, 8],
        [1546, 2],
        [1322, 8],
        [1576, 2],
        [1322, 8],
        [1578, 2],
        [1322, 8],
        [1576, 2],
        [1322, 8],
        [1546, 2],
        [1322, 8]
      ]
    },
    {
      "header": "0xfd04",
      "commands": [
        [1792, 4],
        [844, 0],
        [1824, 4],
        [876, 0],
        [1856, 4],
        [908, 9],
        [1796, 4],
        [844, 0],
        [1828, 4],
        [876, 0],
        [1860, 4],
        [908, 9],
        [1800, 4],
        [844, 0],
        [1832, 4],
        [876, 0],
        [1864, 4],
        [908, 9],
        [1804, 4],
        [844, 0],
        [1836, 4],
        [876, 0],
        [1868, 4],
        [908, 9],
        [1808, 4],
        [844, 0],
        [1840, 4],
        [876, 0],
        [1872, 4],
        [908, 9]
      ]
    }
  ]
}
