{
  "format": 1,
  "record_size": 4,
  "records": [
    [0, 2, 0, 0],
    [0, 0, 0, 0],
    [4, 2, 0, 0],
    [3, 2, 0, 0],
    [3, 0, 2, 0],
    [4, 0, 2, 0],
    [7, 0, 2, 0],
    [0, 6, 0, 0],
    [4, 6, 2, 0],
    [3, 6, 2, 0],
    [4, 1, 0, 0],
    [0, 1, 0, 0],
    [0, 4, 0, 0],
    [3, 2, 6, 0],
    [4, 2, 6, 0],
    [0, 8, 0, 0],
    [4, 2, 4, 0]
  ]
}
