{
  "format": 1,
  "record_size": 4,
  "records": [
    [0, 8, 0, 0],
    [0, 12, 0, 0],
    [0, 0, 0, 0],
    [0, 4, 0, 0],
    [3, 0, 6, 0],
    [0, 6, 0, 0],
    [4, 0, 6, 0],
    [1, 12, 10, 0],
    [1, 10, 8, 0],
    [1, 8, 6, 0],
    [1, 6, 4, 0],
    [1, 4, 6, 0],
    [7, 0, 4, 0],
    [4, 6, 0, 0],
    [3, 6, 0, 0],
    [7, 0, 6, 0],
    [7, 0, 8, 0],
    [0, 1, 0, 0],
    [10, 4, 5, 4]
  ]
}
