{
  "format": 1,
  "record_size": 4,
  "records": [
    [0, 0, 0, 0],
    [4, 8, 4, 0],
    [0, 4, 0, 0],
    [2, 6, 4, 0],
    [0, 8, 0, 0],
    [7, 4, 8, 0],
    [3, 8, 4, 0],
    [7, 0, 8, 0],
    [2, 4, 2, 0],
    [4, 4, 0, 0],
    [2, 2, 0, 0],
    [3, 4, 0, 0],
    [7, 0, 2, 0],
    [1, 0, 2, 0],
    [1, 2, 4, 0],
    [7, 0, 4, 0],
    [4, 8, 0, 0]
  ]
}
