{
  "format": 1,
  "record_size": 4,
  "records": [
    [0, 0, 0, 0],
    [3, 6, 0, 0],
    [1, 0, 2, 0],
    [1, 2, 4, 0],
    [1, 4, 6, 0],
    [1, 6, 8, 0],
    [9, 0, 6, 0],
    [4, 6, 0, 0],
    [9, 6, 1, 0],
    [7, 0, 2, 0],
    [3, 0, 2, 0],
    [1, 5, 4, 0],
    [1, 4, 3, 0],
    [1, 3, 2, 0],
    [1, 2, 1, 0],
    [0, 1, 0, 0],
    [4, 0, 2, 0],
    [0, 20, 0, 0],
    [0, 10, 0, 0],
    [0, 60, 0, 0],
    [1, 22, 20, 0],
    [0, 4, 0, 0]
  ]
}
