{
  "format": 1,
  "record_size": 4,
  "records": [
    [0, 0, 0, 0],
    [0, 8, 0, 0],
    [0, 4, 0, 0],
    [4, 8, 4, 0],
    [4, 4, 0, 0],
    [3, 4, 0, 0],
    [1, 4, 2, 0],
    [1, 2, 0, 0],
    [8, 0, 254, 0],
    [13, 4, 4, 0],
    [4, 0, 4, 0],
    [3, 0, 4, 0],
    [7, 0, 4, 0],
    [8, 254, 0, 0]
  ]
}
