{
  "format": 1,
  "terminators": ["0xfe00", "0xffff"],
  "queues": [
    {
      "header": "0xfd00",
      "commands": [
        [1416, 4],
        [1306, 0],
        [1448, 4],
        [1338, 0],
        [1480, 4],
        [1370, 0],
        [1512, 4],
        [1402, 6],
        [1420, 4],
        [1306, 0],
        [1452, 4],
        [1338, 0],
        [1484, 4],
        [1370, 0],
        [1516, 4],
        [1402, 6],
        [1424, 4],
        [1306, 0],
        [1456, 4],
        [1338, 0],
        [1488, 4],
        [1370, 0],
        [1520, 4],
        [1402, 6]
      ]
    },
    {
      "header": "0xfd01",
      "commands": [
        [1364, 2],
        [1296, 0],
        [1396, 2],
        [1328, 0],
        [1428, 2],
        [1360, 0],
        [1460, 2],
        [1392, 6],
        [1366, 2],
        [1296, 0],
        [1398, 2],
        [1328, 0],
        [1430, 2],
        [1360, 0],
        [1462, 2],
        [1392, 6],
        [1310, 2],
        [1296, 0],
        [1342, 2],
        [1328, 0],
        [1374, 2],
        [1360, 0],
        [1406, 2],
        [1392, 6]
      ]
    }
  ]
}
