{
  "format": 1,
  "terminators": ["0xfe00", "0xffff"],
  "queues": [
    {
      "header": "0xfd00",
      "commands": [
        [1536, 2],
        [1088, 0],
        [1568, 2],
        [1120, 0],
        [1600, 2],
        [1152, 0],
        [1632, 2],
        [1184, 10],
        [1538, 2],
        [1088, 0],
        [1570, 2],
        [1120, 0],
        [1602, 2],
        [1152, 0],
        [1634, 2],
        [1184, 10],
        [1540, 2],
        [1092, 0],
        [1572, 2],
        [1124, 0],
        [1604, 2],
        [1156, 0],
        [1636, 2],
        [1188, 10],
        [1542, 2],
        [1092, 0],
        [1574, 2],
        [1124, 0],
        [1606, 2],
        [1156, 0],
        [1638, 2],
        [1188, 10]
      ]
    },
    {
      "header": "0xfd01",
      "commands": [
        [1552, 8],
        [1104, 0],
        [1584, 8],
        [1136, 0],
        [1616, 8],
        [1168, 0],
        [1648, 8],
        [1200, 0],
        [1680, 8],
        [1232, 0],
        [1712, 8],
        [1264, 0],
        [1745, 1],
        [1180, 0],
        [1777, 1],
        [1212, 0],
        [1747, 1],
        [1181, 0],
        [1779, 1],
        [1213, 0],
        [1811, 1],
        [1245, 10],
        [1560, 8],
        [1104, 0],
        [1592, 8],
        [1136, 0],
        [1624, 8],
        [1168, 0],
        [1656, 8],
        [1200, 0],
        [1688, 8],
        [1232, 0],
        [1720, 8],
        [1264, 0],
        [1744, 1],
        [1180, 0],
        [1776, 1],
        [1212, 0],
        [1746, 1],
        [1181, 0],
        [1778, 1],
        [1213, 0],
        [1810, 1],
        [1245, 10]
      ]
    },
    {
      "header": "0xfd02",
      "commands": [
        [1552, 8],
        [1104, 0],
        [1584, 8],
        [1136, 0],
        [1616, 8],
        [1168, 0],
        [1648, 8],
        [1200, 0],
        [1680, 8],
        [1232, 0],
        [1712, 8],
        [1264, 10],
        [1792, 8],
        [1104, 0],
        [1824, 8],
        [1136, 0],
        [1856, 8],
        [1168, 0],
        [1888, 8],
        [1200, 0],
        [1920, 8],
        [1232, 0],
        [1952, 8],
        [1264, 10]
      ]
    },
    {
      "header": "0xfd03",
      "commands": [
        [1864, 4],
        [1176, 0],
        [1896, 4],
        [1208, 0],
        [1928, 4],
        [1240, 0],
        [1960, 4],
        [1272, 15],
        [1868, 4],
        [1176, 0],
        [1900, 4],
        [1208, 0],
        [1932, 4],
        [1240, 0],
        [1964, 4],
        [1272, 15]
      ]
    },
    {
      "header": "0xfd04",
      "commands": [
        [1748, 2],
        [436, 15],
        [1750, 2],
        [436, 15],
        [1752, 2],
        [436, 15],
        [1754, 2],
        [436, 15]
      ]
    },
    {
      "header": "0xfd05",
      "commands": [
        [1800, 2],
        [526, 0],
        [1832, 2],
        [558, 15],
        [1802, 2],
        [526, 0],
        [1834, 2],
        [558, 15],
        [1804, 2],
        [526, 0],
        [1836, 2],
        [558, 15],
        [1806, 2],
        [526, 0],
        [1838, 2],
        [558, 15]
      ]
    },
    {
      "header": "0xfd06",
      "commands": [
        [1664, 2],
        [1216, 0],
        [1696, 2],
        [1248, 0],
        [1728, 2],
        [1280, 0],
        [1760, 2],
        [1312, 10],
        [1666, 2],
        [1216, 0],
        [1698, 2],
        [1248, 0],
        [1730, 2],
        [1280, 0],
        [1762, 2],
        [1312, 10],
        [1668, 2],
        [1220, 0],
        [1700, 2],
        [1252, 0],
        [1732, 2],
        [1284, 0],
        [1764, 2],
        [1316, 10],
        [1670, 2],
        [1220, 0],
        [1702, 2],
        [1252, 0],
        [1734, 2],
        [1284, 0],
        [1766, 2],
        [1316, 10]
      ]
    },
    {
      "header": "0xfd07",
      "commands": [
        [1544, 2],
        [1096, 0],
        [1576, 2],
        [1128, 0],
        [1608, 2],
        [1160, 0],
        [1640, 2],
        [1192, 10],
        [1546, 2],
        [1096, 0],
        [1578, 2],
        [1128, 0],
        [1610, 2],
        [1160, 0],
        [1642, 2],
        [1192, 10],
        [1548, 2],
        [1100, 0],
        [1580, 2],
        [1132, 0],
        [1612, 2],
        [1164, 0],
        [1644, 2],
        [1196, 10],
        [1550, 2],
        [1100, 0],
        [1582, 2],
        [1132, 0],
        [1614, 2],
        [1164, 0],
        [1646, 2],
        [1196, 10]
      ]
    },
    {
      "header": "0xfd08",
      "commands": [
        [1672, 2],
        [1224, 0],
        [1704, 2],
        [1256, 0],
        [1736, 2],
        [1288, 0],
        [1768, 2],
        [1320, 10],
        [1674, 2],
        [1224, 0],
        [1706, 2],
        [1256, 0],
        [1738, 2],
        [1288, 0],
        [1770, 2],
        [1320, 10],
        [1676, 2],
        [1228, 0],
        [1708, 2],
        [1260, 0],
        [1740, 2],
        [1292, 0],
        [1772, 2],
        [1324, 10],
        [1678, 2],
        [1228, 0],
        [1710, 2],
        [1260, 0],
        [1742, 2],
        [1292, 0],
        [1774, 2],
        [1324, 10]
      ]
    },
    {
      "header": "0xfd09",
      "commands": [
        [1780, 2],
        [468, 0],
        [1812, 2],
        [500, 15],
        [1782, 2],
        [468, 0],
        [1814, 2],
        [500, 15],
        [1780, 2],
        [468, 0],
        [1812, 2],
        [500, 15],
        [1784, 2],
        [468, 0],
        [1816, 2],
        [500, 15]
      ]
    },
    {
      "header": "0xfd0a",
      "commands": [
        [1786, 2],
        [372, 0],
        [1818, 2],
        [404, 15],
        [1788, 2],
        [372, 0],
        [1820, 2],
        [404, 15],
        [1786, 2],
        [372, 0],
        [1818, 2],
        [404, 15],
        [1790, 2],
        [372, 0],
        [1822, 2],
        [404, 15]
      ]
    },
    {
      "header": "0xfd0b",
      "commands": [
        [1756, 1],
        [340, 15],
        [1757, 1],
        [340, 15],
        [1758, 1],
        [340, 15],
        [1759, 1],
        [340, 15]
      ]
    },
    {
      "header": "0xfd0c",
      "commands": [
        [1872, 1],
        [338, 0],
        [1904, 1],
        [370, 15],
        [1873, 1],
        [338, 0],
        [1905, 1],
        [370, 15],
        [1872, 1],
        [338, 0],
        [1904, 1],
        [370, 15],
        [1874, 1],
        [338, 0],
        [1906, 1],
        [370, 15]
      ]
    },
    {
      "header": "0xfd0d",
      "commands": [
        [1936, 1],
        [339, 0],
        [1968, 1],
        [371, 15],
        [1937, 1],
        [339, 0],
        [1969, 1],
        [371, 15],
        [1936, 1],
        [339, 0],
        [1968, 1],
        [371, 15],
        [1938, 1],
        [339, 0],
        [1970, 1],
        [371, 15]
      ]
    },
    {
      "header": "0xfd0e",
      "commands": [
        [1984, 7],
        [1112, 0],
        [2016, 7],
        [1144, 13],
        [1991, 7],
        [1112, 0],
        [2023, 7],
        [1144, 13]
      ]
    }
  ]
}
